111111111111111
1X01C00000000C1
100001111000001
10001110000E001
10P001111000X01
100001111000001
100100000000001
1001X000000C001
10010E000000101
111111111111111
