111111111111111111111111111111
1C110000C010000C110111111111E1
10000111101010111C00001000C001
101101111010100011111000111111
100100011000111001000010X00011
1100110001E1000011101010101011
11101111011001100000C1101000C1
100C00C10011001101000010011111
1011101110C010C101X1011C000001
100X10101110101101010011100101
1010101001101011010110001101C1
100C10C1001P000C010000100001E1
111111111111111111111111111111
