111111111111111111111111111111
10C001110001000C0010100C000011
10110111X101011110100011111011
10000C000000000C0000100X0000E1
111011101111011101100011110111
1000X00C10000100011C10000C0001
110111101011010101100011111101
1P000C0000C00100X0001000C00001
111111111111111111111111111111