1111111111111
101C0000X00C1
100X010101001
1P0011E000001
1111111111111