1111111111111111111111111111111111
1E0C000000X0000C00000C00000X000001
10100101C0100000101001000000010101
1010010010101010001001C00000010101
1P0000000C00C000X000000000C00000C1
1111111111111111111111111111111111