111111111111111
1P1C000000000C1
101011111111001
100010C00000001
101010101C001C1
100010101110101
1C011000C0000E1
111111111111111
